R 1200 800


NO ./textures/pokemon-collection/text-01.xpm
SO ./textures/pokemon-collection/text-02.xpm
C 						157,23,88

S ./textures/sprite4.xpm
F 212, 238, 255
WE ./textures/pokemon-collection/text-04.xpm
EA ./textures/pokemon-collection/text-03.xpm

S ./textures/sprite1.xpm
S ./textures/sprite2.xpm
S ./textures/sprite3.xpm

1111111111111111111111111111111111111111111111111111111111111111111111111111111
1000000000000000000000000111100000000000000000000000000000000000000000000000001
1001100000000300000002000000000003000000020000200000000000000000000000000000001
1011111000000000050000000000000000000000000400000000000000000000000000000000001
1111000000000000000000111111111111110000000000000000000000000000000000000000001
1000000000111111111000011111111111100001111111111000000000000000000000000000001
1040000000000000000020000000000000000400000000000000000000000000000000000000001
1000000000000000000000000000000000000000000000000000000000000000000000000000001
1002000111111110000111111111000011111110001111111100000000000000000000000000001
1000000111111110000111111100000000111110001111111100000000000000000000000000001
1110000000000000000000000000005000000000000000000000000000000000000000000000001
1111002000000000000000000000000000000000000000500000000000000000000000000000001
1000000000300111111111111111111111111111111100000000000000000000000000000000001
10000000000000011111111111111111111111111100000000E0000000000000000000000000001
1000000000000000000000000000000000000000000000000000000000000000000000000000001
1000000000000000000000000000000000000000000000000000000000000000000000000000001
1000000000000000000000000000000000000000000000000000000000000000000000000000001
1000000000000000000000000000000000000000000000000000000000000000000000000000001
1000000000000000000000000000000000000000000000000000000000000000000000000000001
1000000000000000000000000000000000000000000000000000000000000000000000000000001
1000000000000000000000000000000000000000000000000000000000000000000000000000001
1000000000000000000000000000000000000000000000000000000000000000000000000000001
1000000000000000000000000000000000000000000000000000000000000000000000000000001
1000000000000000000000000000000000000000000000000000000000000000000000000000001
1000000000000000000000000000000000000000000000000000000000000000000000000000001
1000000000000000000000000000000000000000000000000000000000000000000000000000001
1000000000000000000000000000000000000000000000000000000000000000000000000000001
1000000000000000000000000000000000000000000000000000000000000000000000000000001
1000000000000000000000000000000000000000000000000000000000000000000000000000001
1000000000000000000000000000000000000000000000000000000000000000000000000000001
1000000000000000000000000000000000000000000000000000000000000000000000000000001
1000000000000000000000000000000000000000000000000000000000000000000000000000001
1000000000000000000000000000000000000000000000000000000000000000000000000000001
1000000000000000000000000000000000000000000000000000000000000000000000000000001
1000000000000000000000000000000000000000000000000000000000000000000000000000001
1000000000000000000000000000000000000000000000000000000000000000000000000000001
1000000000000000000000000000000000000000000000000000000000000000000000000000001
1000000000000000000000000000000000000000000000000000000000000000000000000000001
1000000000000000000000000000000000000000000000000000000000000000000000000000001
1000000000000000000000000000000000000000000000000000000000000000000000000000001
1000000000000000000000000000000000000000000000000000000000000000000000000000001
1000000000000000000000000000000000000000000000000000000000000000000000000000001
1000000000000000000000000000000000000000000000000000000000000000000000000000001
1000000000000000000000000000000000000000000000000000000000000000000000000000001
1000000000000000000000000000000000000000000000000000000000000000000000000000001
1000000000000000000000000000000000000000000000000000000000000000000000000000001
1000000000000000000000000000000000000000000000000000000000000000000000000000001
1000000000000000000000000000000000000000000000000000000000000000000000000000001
1111111111111111111111111111111111111111111111111111111111111111111111111111111