R 1200 800
      NO ./textures/wonderful-collection/text-01.xpm
      SO          ./textures/wonderful-collection/text-02.xpm
WE        ./textures/wonderful-collection/text-03.xpm
EA ./textures/wonderful-collection/text-04.xpm
C          255,246,0




S ./textures/sprite4.xpm




		F 0,255,255

11111111111111111111111111111111111
1000000000000000000000000000001
10E0000000011111111111111100001
1000200000000000000000000000011111111111111
1111111111111110000000000000000000000001
102000001111111111111100000000000001
10002000000000000000000000011111111111111
11111111111111111111111111111111111
