   R          1000    700
      NO ./textures/metal-flowers-collection/text-01.xpm
      SO       ./textures/metal-flowers-collection/text-02.xpm
WE        ./textures/metal-flowers-collection/text-03.xpm
  EA         ./textures/metal-flowers-collection/text-08.xpm

               C   111    , 229,  0



S ./textures/sprite1.xpm
S ./textures/sprite2.xpm
S ./textures/sprite3.xpm


	  	F 255, 51, 51

111111111111111111111111111111111111111111111111
111111000000000000000000000000000000000000000011
111111000020000000000000000400002000001000000011
110000100000001111111111100200000020010000000011
110020004000011111100000101100000200000400001111
110000000002003000000000000000003000001111111111
111111111000000000000200004020000001111111111111
111111111002000110000000000000000000000000011111
100000000000011100000002000003000020001111111111
1000000030000011100000000000000000   00000011111111
111111111000000S20000010100001100000110000011111
111111000002000000400111100000011000011100000011
111111000000000000001111100000011002001111000011
111111001111000111111111000002000020000111111111
11111111111111111111111000000003000000011111111
111111111111111111111111111111111111111111111111

