                       R				 1920 1080


NO ./textures/stone-collection/text-01.xpm
SO ./textures/stone-collection/text-02.xpm
C 						157,23,88
EA ./textures/stone-collection/text-04.xpm

S ./textures/light.xpm
F 212, 238, 255
WE ./textures/stone-collection/text-03.xpm

1111111111111111111111111111111111111111111
1000000000011111111111000000000000000000001
1000200000011110000111110000002000000200001
1000000020000000200000002000000000000000001
1000000000000000000000000002000002000000001
1002000001111100001111000000000000000000001
1000000000111110011100000000200020000002001
1000200000011111111000000000000000002000001
10011110000011111110011111111111100000N0001
1111110000001100011100000111111111100000001
1111110000000100001110000001111111100000001
11111100000000000011110000001111111000000000001
1001111111100000000000000000111111000000001
1001111111000011111110001100111000000002001
1000000000000000111110000000000000000000001
1000000200000001111000000000001111000200001
1002000002000001111111111111110000000000001
1000000000000001111111111111110000020000201
1000000000000000001111111111000000000000001
1111111111111111111111111111111111111111111