 R          1600    900
      NO ./textures/metal-flowers-collection/text-01.xpm
      SO       ./textures/metal-flowers-collection/text-02.xpm
WE        ./textures/metal-flowers-collection/text-03.xpm
  EA         ./textures/metal-flowers-collection/text-04.xpm

               C   0, 255,  158



S ./textures/sprite.xpm



	  	F 151, 0, 71

1111111111111111111111111111111111111111111111111111111111111111111
1000000000000000000000000000001111000000000000000000000001110000001
1000000011000000002200000000000111000000000000022000000001100000001
1000000111110000000000000000000000000000000000000000000000111000001
1000200000000002000000000000000000000000000000000200001111110000001
1000000001000000000001111111111111111111111111110000000000000000001
1000000001000020000111111111111111111111111111111100000002000200001
1000001110000000011111110001111111111111100011111111000000000000001
1000100000000001111111110000111111111111000011111111110000000000001
1000000200000000000000000200000000000000002000000000000000020000001
10000000000000000000000000000000E0000000000000000000000000000000001
1000000020001111111111111111111100001111111111111111111110000000001
1002000000001111111111111111110000000011111111111111111110000000001
1000000000001111111111111111111110011111111111111111111110000000001
1002220000001111111111111111111102201111111111111111111110000002001
1000000020001111111100111111111110011111111111001111111110000000001
1000000000000111111100010010011000001010011000001111111100020000001
1002020000000000000000000000000000000000000000000000000000000000001
1000001000000000111111001101001100101100100100111111000000000000001
1002001110002002001111111111111111111111111111111000000000111100001
1000000000000000000011111111111111111111111111100000000000000000001
1111111111111111111111111111111111111111111111111111111111111111111