R 1200 800
      NO ./textures/wonderful-collection/text-01.xpm
      SO          ./textures/wonderful-collection/text-02.xpm
WE        ./textures/wonderful-collection/text-03.xpm
EA ./textures/wonderful-collection/text-04.xpm
C          255,246,0




S ./textures/sprite4.xpm




		F 0,255,255

1111111
1000001
10E0001
1000201
1111111
