  R          1200    800
      NO ./textures/silver-collection/text-01.xpm
      SO       ./textures/silver-collection/text-02.xpm
WE        ./textures/silver-collection/text-03.xpm
  EA         ./textures/silver-collection/text-04.xpm

        	       C   204, 1,  1




S ./textures/sprite1.xpm

	  	F 0, 0, 0



1111111111111111111111111111111111111111111111111111
1000000000000000000000000111100011111111111
10011000000002000000000020000200001
1011111000000000000000000000000001
111100000000000000000011111111111111
10000000001111111110000111111111111000011111111110001111111111111
102000000000000000000000000000000000000000000000001
100000000000000000000000000000000000000000000000000111111
10020001111111100001111111110000111111100011111111001
10000001111111100001111111000000001111100011111111001111111111111
1110000000000000000000000000000000000000000000000000000001
111100000000000000000000000000000000000000020000W00020001
10000000020011111111111111111111111111111110000000002000001
10000000000000011111111111111111111111111100000000000000000000001
11111111111111111111111111111111111111111111111111111

