  R          500    250
      NO ./textures/pokemon-collection/text-01.xpm
      SO       ./textures/pokemon-collection/text-02.xpm
WE        ./textures/pokemon-collection/text-03.xpm
  EA         ./textures/pokemon-collection/text-04.xpm

        	       C   204, 1,  1




S ./textures/lamp.xpm

	  	F 0, 0, 0



111111
102001
10N001
111111



