        R      1700         900
										EA ./textures/blue-collection/text-01.xpm
										NO ./textures/blue-collection/text-02.xpm

SO ./textures/blue-collection/text-03.xpm




WE ./textures/blue-collection/text-04.xpm


S ./textures/sprite3.xpm
F 0,79,131
C 159,159,159


111111111111111111111111111111
100000000000000001110000001111
100020000000200011001100200001
1000000000W0001100001100000001
111110000000011000000100000001
111000020000110000000000000001
100000000000000000000000200001
10000111000000000111000001111
100000000000100000000000000001
10000000000010000000000000001
111111111111111111111111111111