R 1280 720
      NO ./textures/pokemon-collection/text-01.xpm
      SO       ./textures/pokemon-collection/text-02.xpm
WE        ./textures/pokemon-collection/text-03.xpm
  EA         ./textures/pokemon-collection/text-04.xpm




S ./textures/lamp.xpm

F 38, 80, 0
C 0, 100, 255

111111
100201
100001
100001
10N001
111111



