R 1200 800
      NO ./textures/wonderful-collection/text-01.xpm
      SO          ./textures/wonderful-collection/text-02.xpm
WE        ./textures/wonderful-collection/text-03.xpm
EA ./textures/wonderful-collection/text-04.xpm
C          255,246,0




S ./textures/sprite4.xpm




		F 0,255,255

111111111111111111111111111111111111111111
100000011000000000111000000000000110000001
111102000002110020000000000200000110020001
100000000000000000010011100111100000000001
100000111000000000000000010001100000011001
100000110020001000000102010200000011020001
100000000000000110000000000000000200000001
110000000000000000000000200000000002001101
100001110000000000011000100110000110001101
102000002000000110000000111000200000002001
10000E000000001111111000011000000000000001
111111111111111111111111111111111111111111