        R      1700         900
										EA ./textures/blue-collection/text-01.xpm
										NO ./textures/blue-collection/text-02.xpm

SO ./textures/blue-collection/text-03.xpm




WE ./textures/blue-collection/text-04.xpm


S ./textures/sprite3.xpm
F 0,79,131
C 159,159,159


11111111111111111111111111111111111111111111111111111
10000000000000000111000011110000011110000110000000001
10002000000020001100110001100001100001100011000200001
10000000000000110000110000000110000001100002000000001
11111000000001100000011000001100020000110000000000001
11100002000011000000000000000000000000011000000000001
1000000000000000000000000W000000000000000000000200001
10000111000000000011000000011000011000000000000000011
10000011100110000001000100110001110000001101110000001
10001100000011000010001100110000110000011000001100001
10110000000001100000011100111100000000011000000001001
11000000020001100000000000000000000011000002000001001
11000000000000110011111000111110000010000200000011001
11000020000000011011110000111111100000000000011111001
10000000000000000000000000000000000000000000000000001
11111111111111111111111111111111111111111111111111111