R 700 703
NO./path_to_the_north_texture
SO./path_to_the_south_texture
WE./path_to_the_west_texture
EA./path_to_the_east_texture
C225,30,0



S./path_to_the_sprite_texture



		F220,100,0

11111111111
10000000001
10000010001
10000N00001
10000100001
10000000001
11111111111