R      1700         900
										EA ./textures/silver-collection/text-01.xpm
										NO ./textures/silver-collection/text-02.xpm

SO ./textures/silver-collection/text-03.xpm




WE ./textures/silver-collection/text-04.xpm


S ./textures/sprite2.xpm
F 0,79,131
C 159,159,159


111111111111111111111111111111111111111111111111111111111111111111111111111111111
100000000000000000000011111111100000000000000000000111111110000000000000000000001
10000000000000000000011000000001100000000S000000011000000001100002000000000200001
100000000020000000011000000000011000000000000001100000000001100000000002000000001
100000000000000000110000020000001100020002000011000200002000110000000000000000001
100000022000000001100000000000000000000000000000000000000000011000000000000000001
100000000000000011000000000000000000000000000000000000000000011000020000000000001
100000000000000011000000110001100001100000000110000110011000000110000000000000001
100000000000000011000001100000110001100000000110001100001000001100000000002000001
100000000000000011000001100000100011011000110110001100000100000110000000000000001
100000111000000011000001100000100011110000011100011100001000001100000001110000001
100011000000000001100000100011000111111000011100001100010000011000000000001100001
101100000000000000110000000000001111110000001111100000000000011000000000000001101
110000000200000000110000000000000000000000000000000000000011000000000002000001101
110000000000000000011000000001111100000011111111100000000110000200000000000001101
110000000000002000001100000011111000000000111111111000001100000000000000000001101
100110000000000000000000111111111110000001111111111111111100000200002000000011001
100011000000020000000020000001111111000000011111111111000000000000002000001100001
100000000000000000000000000000000000000000000000000000000000000000000000000000001
111111111111111111111111111111111111111111111111111111111111111111111111111111111