R 700 703
      NO ./path_to_the_north_texture
      SO          ./path_to_the_south_texture
WE        ./path_to_the_west_texture
EA ./path_to_the_east_texture
C          225,30,0



S ./path_to_the_sprite_texture



		F 220,100,0

1 1 1 1 1 1 1 1 1 1 1 1 1 1 1 1
1 1 1 1 1 1 1 1 1 2 1 1 1 1 1 1
1 0 0 0 0 0 0 0 1 0 1 1 0 0 2 1
1 0 0 0 0 0 0 0 0 1 1 1 0 0 0 1
1 0 0 1 0 0 W 0 0 0 0 0 0 0 0 1
1 0 1 1 0 0 0 0 0 1 1 1 0 0 0 1
1 0 0 0 0 1 0 0 2 0 1 1 0 0 0 1
1 1 1 1 0 0 0 1 1 1 1 1 1 1 0 1
1 1 1 1 0 1 0 1 1 1 1 1 1 1 0 1
1 1 0 0 0 0 0 0 1 1 0 1 0 1 0 1
1 0 0 0 2 0 0 0 0 0 0 0 0 0 0 1
1 0 0 0 0 0 0 0 0 0 0 0 0 0 0 1
1 1 0 0 0 0 0 0 1 1 0 1 0 1 0 1
1 1 1 1 0 1 2 1 1 1 1 1 0 1 0 1
1 1 1 1 1 1 1 1 1 1 1 1 1 1 1 1