  R          1200    800
      NO ./textures/silver-collection/text-01.xpm
      SO       ./textures/silver-collection/text-02.xpm
WE        ./textures/silver-collection/text-03.xpm
  EA         ./textures/silver-collection/text-04.xpm

        	       C   204, 1,  1




S ./textures/sprite2.xpm

	  	F 0, 0, 0



1111111111111111111111111111111111111111111111111111
1000000000000000000000000111100011111111111
10011000000002000000000020000200001
10000000001111111110000111111111111000011111111110001111111111111
1020000200000000000000000000000000000000000000000001
100000000000000000000000000000000000000000000000000111111
10000001111111100001111111000000001111100011111111001111111111111
1110000020000000000000000000000200000000000000000000000001
111100000000000002000000000000000000000000020000W00020001
11111111111111111111111111111111111111111111111111111

