R 1800 1300


NO ./textures/pokemon-collection/text-01.xpm
SO ./textures/pokemon-collection/text-02.xpm
C 						157,23,88

S ./textures/sprite4.xpm
F 212, 238, 255
WE ./textures/pokemon-collection/text-04.xpm
EA ./textures/pokemon-collection/text-03.xpm

S ./textures/sprite1.xpm
S ./textures/sprite2.xpm
S ./textures/sprite3.xpm

11111111111111111111111111111111111111111111111111111
10000000000000000000000001111000000000000000000000001
10011000000003000000020000000000030000000200002000001
10111110000000000500000000000000000000000004000000001
11110000000000000000001111111111111100000000000000001
10000000001111111110000111111111111000011111111110001
10400000000000000000200000000000000004000000000000001
100000000000000000000000000E0000000000000000000000001
10020001111111100001111111110000111111100011111111001
10000001111111100001111111000000001111100011111111001
11100000000000000000000000000050000000000000000000001
11110020000000000000000000000000000000000000005000001
10000000003001111111111111111111111111111111000000001
10000000000000011111111111111111111111111100000000001
11111111111111111111111111111111111111111111111111111