R 700 500


NO ./textures/pokemon-collection/text-01.xpm
SO ./textures/pokemon-collection/text-02.xpm
C 						157,23,88
EA ./textures/pokemon-collection/text-03.xpm

S ./textures/sprite4.xpm
F 212, 238, 255
WE ./textures/pokemon-collection/text-04.xpm

S ./textures/sprite1.xpm
S ./textures/sprite2.xpm
S ./textures/sprite3.xpm

1111111111111111
1100010005000501
1002001203002001
10200N0020011001
1002011100000201
1030000002000401
1000200000011001
1000300050000301
1111111111111111