R				 1920 1080


NO ./textures/metal-flowers-collection/text-05.xpm
SO ./textures/metal-flowers-collection/text-06.xpm
C 						157,23,88
EA ./textures/metal-flowers-collection/text-07.xpm

S ./textures/sprite.xpm
F 212, 238, 255
WE ./textures/metal-flowers-collection/text-08.xpm

111111111111111111111111111111111111111111111111111111111111
100000000000000000000000000000000000000000000000000000000001
100000000001111111111100000000000000000000000000000000000001
100000000001111000011111000000200000000000000000000002000001
100002000011110002001111000000000000000000200020000000000001
100000000000000000000000000000000000000000000000000000000001
100000000111100000011110000000000200000000000000000000000001
100200000111110000111100000000000000000000000000000000000001
100000000011111011110000000000002000000000000200000000000001
100020000001111111100000000000000000000000000000000000000001
100000000000000000000000000000000000000000002000002020000001
100000000110000001111111111000000000000000000000000000000001
100000111100000111111111111111100000000000000000000000000001
100011110000001111111111111111111100000000000000000000000001
100111100000111111100111111111111000000000000000S00000000001
111111000000110001110000011111111110000000000000000000000001
111111000000010000111000000111111110000000000000000000000001
111111000000000000111100000011111110000000000000000000000001
111111100000000000011110000111111100000000020000000200000001
111111110000000000001111000111111100000000000000000000000001
100111111110000000000000000011111100000000000000000000000001
100111111111111111111000110011100000000000000000000200020001
10000011111111111111100011000000000    0000000020000000000000001
100000000011111111111100011100000000000000000000000000000001
100000000000000011111000000000000000000000000000000000000001
100000020000000111100000000000111100000000020002000020000001
100200000200000111111111111111000000000000000000000000000001
100000000000000111111111111111000000000000000000000000000001
100000000000000000111111111100000000200000000002000000000001
111111111111111111111111111111111111111111111111111111111111