  R          1200    800
      NO ./textures/silver-collection/text-01.xpm
      SO       ./textures/silver-collection/text-02.xpm
WE        ./textures/silver-collection/text-03.xpm
  EA         ./textures/silver-collection/text-04.xpm

        	       C   254, 1,  1



S ./textures/sprite3.xpm

	  	F 0, 0, 0



11111111111111111111111111111111111111111111111111111
10000000000000000000000001111000000000000011111111111
10011000000002000000020000000000000000000200002000001
10111110000000000000000000000000000000000000000000001
11110000000000000000001111111111111100000000000000001
10000000001111111110000111111111111000011111111110001
10200000000000000000200000000000000002000000000000001
10000000000000000000000000000000000000000000000000001
10020001111111100001111111110000111111100011111111001
10000001111111100001111111000000001111100011111111001
11100000000000000000000000000000000000000000000000001
11110020000000000000000000000000000000000000000000001
10000000002001111111111111111111111111111111000000001
1000000000000001111111111111111111111111110000000E001
11111111111111111111111111111111111111111111111111111

