                       R				 1920 1080


NO ./textures/stone-collection/text-01.xpm
SO ./textures/stone-collection/text-02.xpm
C 						157,23,88
EA ./textures/stone-collection/text-04.xpm

S ./textures/sprite2.xpm
F 212, 238, 255
WE ./textures/stone-collection/text-03.xpm

111111111111111111111111111111111111
100020000001111000011111000000200001
100000002000000020000000W0000000001
100020000001111111100000000002000001
111111000000000000111100111100000001
10000000000000011000000000020000201
10000000000000011000000000020000201
111111111111111111111111111111111111