0  R          1200    900
      NO ./textures/brick.xpm
      SO       ./textures/grass.xpm
WE        ./textures/metal.xpm
  EA         ./textures/stone.xpm

               C   225, 30,  0



S ./textures/wood.xpm



	  	F 223, 1, 149

1111111111111111111111111111111111111111111111111111111111111111111
1000000000000000000000000000001111000000000000000000000001110000001
1000000011000000000000000000000111000000000000000000000001100000001
1000000111110000000000000000000111100000000000000000000000111000001
1000000000000000000000011111111111111111111110000000001111110000001
1000000001000000000001111111111111111111111111110000000000000000001
1000000001000000000111111111111111111111111111111100000000000000001
1000001110000000011111111001111111111111100111111111000000000000001
1000100000000001111111110000111111111111000011111111110000000000001
1000000000000111111111100200011111111111020001111111111100020000001
1000000000000000000000000000000000000000000000000000000000000000001
1000000000001111111111111111111100001111111111111111111110000000001
1000000000001111111111111111110000000011111111111111111110000000001
1000000000001111111111111111111110011111111111111111111110000000001
1000000000001111111111111111111112211111111111111111111110000000001
1000000000001111111110111111111110011111111111011111111110000000001
1000000000000111111110011011011010011011011010011111111100000000001
1000000000000000000000000000000000000000000000000000000000000000001
1000001000000000111111001101101100101101101011111110000000000000001
1000001110000000001111111111111111111111111111111000000000111100001
1000000000000000000011111111111111111111111111100000000000000000001
0111111111111111111111111111111111111111111111111111111111111111111