R 700 500


NO ./textures/metal-flowers-collection/text-05.xpm
SO ./textures/metal-flowers-collection/text-06.xpm
C 						157,23,88
EA ./textures/metal-flowers-collection/text-07.xpm

S ./textures/sprite4.xpm
F 212, 238, 255
WE ./textures/metal-flowers-collection/text-08.xpm
1111111111111111
1020000000020001
1000001200002001
10200N0000000001
1002010000000201
1000000020000201
1000000120000201
1000000120000201
1111111111111111