R 1800 1200


NO ./textures/candies-collection/text-01.xpm
SO ./textures/candies-collection/text-02.xpm
C 						157,23,88

S ./textures/sprite2.xpm
F 212, 238, 255
WE ./textures/candies-collection/text-04.xpm
EA ./textures/candies-collection/text-03.xpm




11111111111111111111111111111111111111
10011000000002000000000000200002000001
11110000000000000000000000000000200001
10000000001111111110000011111111110001
10200000000000000000202000000000000001
10000000000000000000000000000000000001
10020001111111100001111100011111111001
10000001111111100001111100011111111001
1110000000000000000200000000000000001
1111002000000000000000000000000002001
11111111111111111111111111111111111111