   R         1000   700
      NO ./textures/gravity-collection/text-01.xpm
      SO       ./textures/gravity-collection/text-02.xpm
WE        ./textures/gravity-collection/text-03.xpm
  EA         ./textures/gravity-collection/text-04.xpm

               C   130 , 0 , 255



S ./textures/sprite1.xpm
S ./textures/sprite2.xpm
S ./textures/sprite3.xpm

L ./textures/life.xpm
A ./textures/frame.xpm


	  	F 0 , 231 , 87

111111111111111111111111111111111111111111111111
111111000000000000000000000000000000000000000011
111111000000000000000000000400000000001000000011
110000100000001111111111100200000000010000000011
110020004000011111100000101100000200000400001111
110000000000003000000000000000003000001111111111
111111111000000000000200004000000001111111111111
111111111002000110000000000000000000000000011111
100000000000011100000002000003000020001111111111
1000000030000011100000000000000000   00000011111111
111111111000000W20000010100001100000110000011111
111111000000000000400111100000011000011100000011
111111000000000000001111100000011002001111000011
111111001111000111111111000002000000000111111111
11111111111111111111111000000003000000011111111
111111111111111111111111111111111111111111111111

