                       R				 1920 1080


NO ./textures/stone-collection/text-01.xpm
SO ./textures/stone-collection/text-02.xpm
C 						157,23,88
EA ./textures/stone-collection/text-04.xpm

S ./textures/sprite2.xpm
F 212, 238, 255
WE ./textures/stone-collection/text-03.xpm

11111111111111111111111111111111
10002000000111100011000000200001
10000000200000002000W0000000001
10000000200000002000W0000000001
10002000000111111100000002000001
11111100000000000000111100000001
1000000000000001100000020000201
1000000000000001100000020000201
11111111111111111111111111111111